111111111111
111C111C01E1
110001000001
100100001111
1P101C100C01
111111111111
